NO img/STONE2.xpm
WE img/SP_ROCK2.xpm
SO img/WALL.xpm
EA img/STONE3.xpm

F 0,32,0
C 120,0,16

 1111111        111111111
110000011      10000000001
100000001     1000000000001
 1000001     100000000000001
  11011      1000000000000001
   101        1000000100000001
   101         100001 100000001
   101111111111100000100000001
   1000000000000011100000N00001
   1011111111111000000000001111
1111111111111111111111111111111111