NO img/STONE2.xpm
WE img/SP_ROCK2.xpm
SO img/WALL.xpm
EA img/STONE3.xpm

F 252,32,0
C 65,252,16

11111111111111111111111111111111111111111111111111111111111111111111111111111111111111111111111111111111111111111111
10000000000000000000000000000000000000000000000000000000000000000000000000000000000000000000000000000000000000000S001
111111111111111111111111111111111111111111111111111111111111111111111111111111111111111111111111111111111111111111111